15
15
-1 -1 -1 -1 -1 -1 -1 -1 -1 -1 -1 -1 
-1 1 1 1 1 1 0 0 -21 -6 -7 -7 -7 -7 -1
-1 1 1 1 1 1 0 0 0 -8 -8 -8 -8 -8 -1
-1 1 1 1 1 1 0 0 0 -9 -10 -10 -10 -10 -1
-1 1 1 1 1 1 0 0 0 -11 -12 -13 -14 -15 -1
-1 1 1 1 1 1 0 0 0 -16 -17 -18 -19 -20 -1
-1 0 0 0 0 0 0 0 0 0 0 0 0 0 -1
-1 0 0 0 -21 0 0 0 0 0 0 0 0 0 -1
-1 0 0 0 0 0 0 0 0 0 -21 0 0 0 -1
-1 0 0 0 0 0 0 0 0 0 0 0 0 0 -1
-1 2 2 2 2 0 0 0 0 0 0 0 0 0 -1
-1 2 2 -21 2 2 0 0 0 0 -3 0 0 0 -1
-1 2 2 2 2 2 2 0 0 0 -4 0 0 0 -1
-1 2 2 2 2 2 2 2 0 0 -5 0 0 0 -1
-1 -1 -1 -1 -1 -1 -1 -1 -1 -1 -1 -1 -1 -1


