15
17
-24 -24 -24 -24 -24 -24 -24 -24 -24 -24 -24 -24 -24 -24 -24 -24 -24
-23 -22 -22 -22 -22 -22 -22 -22 -22 -22 -22 -22 -22 -22 -22 -22 -23
-23 -22 -22 -22 -22 -22 -22 -22 -22 -22 -22 -22 -22 -22 -22 -22 -23
-23 -22 -22 -22 -22 -22 -22 -22 -22 -22 -22 -22 -22 -22 -22 -22 -23
-23 4 4 4 4 4 4 4 -21 4 4 4 4 4 4 4 -23
-23 4 4 4 4 4 4 4 4 4 4 4 4 4 4 4 -23
-23 4 4 4 4 4 4 4 4 4 4 4 4 4 4 4 -23
-23 4 4 4 4 4 4 4 4 4 4 4 4 4 4 4 -23
-23 4 4 4 4 4 4 4 4 4 4 4 4 4 4 4 -23
-23 4 4 4 4 4 4 4 4 4 4 4 4 4 4 4 -23
-23 4 4 4 4 4 4 4 4 4 4 4 4 4 4 4 -23
-23 4 4 4 4 4 4 4 4 4 4 4 4 4 4 4 -23
-23 4 4 4 4 4 4 4 4 4 4 4 4 4 4 4 -23
-23 4 4 4 4 4 4 4 4 4 4 4 4 4 4 4 -23
-24 -24 -24 -24 -24 -24 -24 -24 -25 -24 -24 -24 -24 -24 -24 -24 -24
