15
17
-24 -24 -24 -24 -24 -24 -24 -24 -24 -24 -24 -24 -24 -24 -24 -24 -24
-23 -22 -22 -22 -22 -22 -22 -22 -22 -22 -22 -22 -22 -22 -22 -22 -23
-23 -22 -22 -22 -22 -22 -22 -22 -22 -22 -22 -22 -22 -22 -22 -22 -23
-23 -22 -22 -22 -22 -22 -22 -22 -22 -22 -22 -22 -22 -22 -22 -22 -23
-23 4 4 4 4 4 4 4 -21|10005 4 4 4 4 4 4 4 -23
-23 4 4 4 4 4 4 4 4 4 4 4 4 4 4 4 -23
-23 4 4 4 4 4 4 4 4 4 4 4 4 4 4 4 -23
-23 4 4 4 4 4 4 4 4 4 4 4 4 4 4 4 -23
-23 4 4 4 4 4 4 4 4 4 4 4 4 4 4 4 -23
-23 4 4 4 4 4 4 4 4 4 4 4 4 4 4 4 -23
-23 4 4 4 4 4 4 4 4 4 4 4 4 4 4 4 -23
-23 4 4 4 4 4 4 4 4 4 4 4 4 4 4 4 -23
-23 4 4 4 4 4 4 4 4 4 4 4 4 4 4 4 -23
-23 4 4 4 4 4 4 4 4|20002 4 4 4 4 4 4 4 -23
-24 -24 -24 -24 -24 -24 -24 -24 -99999 -24 -24 -24 -24 -24 -24 -24 -24	